************
*x  *   *  *
***   * ** *
*   * *    *
* * **  ** *
*  **   *  *
*     *   **
* *  ** *  *
* ***   ** *
* * ** * * *
* *       y*
************